/*
		int stage1[11][6] = 
			{{9,9,9,9,9,9},
			{9,9,9,9,9,9},
			{9,9,9,9,9,9},
			{9,9,9,9,9,9},
			{9,9,9,9,9,9},
			{9,9,9,9,9,9},
			{9,9,3,9,9,9},
			{3,3,2,3,9,9},
			{2,2,1,2,9,9},
			{1,1,0,1,9,9},
			{0,0,1,0,9,9}}; */

        int stage1[11][6] = 
		{{9,9,9,9,9,9},
		 {9,1,9,9,0,9},
		 {9,3,1,0,2,9},
		 {3,2,2,1,1,9},
		 {1,3,2,2,1,9},
		 {0,1,1,2,2,9},
		 {0,0,3,1,2,9},
		 {1,0,2,3,1,9},
		 {0,1,1,0,2,0},
		 {3,0,3,3,1,2},
		 {0,0,2,3,0,0}};

		int stage2[11][6] = 
			{{9,9,9,9,9,9},
			{9,9,9,9,9,9},
			{9,9,9,9,9,9},
			{9,9,9,9,9,9},
			{9,9,9,9,9,9},
			{9,9,3,9,9,9},
			{9,9,1,9,9,9},
			{9,9,2,9,9,9},
			{3,3,2,3,3,9},
			{2,2,1,2,2,9},
			{1,1,2,1,1,9}};


		int stage3[11][6] = 
			{{9,9,9,9,9,9},
			{9,9,9,9,9,9},
			{9,9,9,9,9,9},
			{9,9,9,9,9,9},
			{9,9,9,9,9,9},
			{9,9,9,3,9,9},
			{9,9,3,0,9,9},
			{9,9,0,1,9,9},
			{9,9,1,2,0,0},
			{3,3,2,3,2,2},
			{1,1,3,1,3,3}};

		int stage5[11][6] = 
			{{9,9,9,9,9,9},
			{9,9,9,9,9,9},
			{9,9,9,9,9,9},
			{9,9,9,9,9,9},
			{0,9,3,9,0,9},
			{0,3,2,1,0,9},
			{2,0,2,1,1,9},
			{2,0,3,2,2,9},
			{3,3,0,3,1,9},
			{2,0,2,1,1,9},
			{0,0,2,3,0,9}};

		int stage4[11][6] = 
			{{9,9,9,9,9,9},
			{9,9,9,9,9,9},
			{9,9,9,9,9,9},
			{9,9,9,9,9,9},
			{9,9,3,9,9,9},
			{9,3,0,9,9,9},
			{9,0,3,9,9,9},
			{9,3,1,3,9,9},
			{1,1,3,0,9,9},
			{3,3,0,3,2,9},
			{0,0,2,2,0,9}};

		int stage8[11][6] = 
			{{9,9,9,9,9,9},
			{9,9,9,9,9,9},
			{9,9,9,9,9,9},
			{9,9,9,9,9,9},
			{9,9,9,9,9,9},
			{9,9,1,9,9,9},
			{9,9,1,9,9,9},
			{9,9,0,2,2,0},
			{9,0,3,0,1,2},
			{3,3,1,1,2,0},
			{1,1,2,2,0,0}};

		int stage10[11][6] =
			{{9,9,9,9,9,9},
			{9,9,9,0,9,9},
			{9,0,0,3,9,9},
			{9,1,1,3,9,9},
			{1,2,2,1,0,0},
			{2,0,1,0,2,3},
			{3,0,1,3,2,3},
			{3,2,3,3,1,1},
			{0,1,0,2,0,0},
			{3,1,1,0,3,3},
			{3,0,1,3,2,3}};

		int stage6[11][6] = 
			{{9,9,9,9,9,9},
			{9,9,9,9,9,9},
			{2,2,0,3,3,9},
			{2,2,1,3,3,9},
			{3,3,1,0,0,9},
			{3,3,2,0,0,9},
			{2,2,0,2,2,9},
			{3,3,1,0,0,9},
			{3,3,1,0,0,9},
			{2,2,0,3,3,9},
			{2,2,0,3,3,9}};

		int stage9[11][6] = 
			{{9,9,9,9,9,9},
			{9,3,9,9,9,9},
			{9,0,9,9,9,9},
			{9,3,3,9,9,9},
			{9,2,0,3,9,9},
			{3,3,1,1,0,9},
			{1,2,1,1,2,9},
			{3,2,3,3,2,1},
			{1,0,1,0,0,1},
			{1,0,2,1,3,3},
			{2,2,0,0,2,1}};


		int stage7[11][6] = 
			{{9,9,9,9,9,9},
			{9,9,9,9,9,9},
			{9,9,9,9,9,9},
			{9,9,9,1,1,9},
			{9,9,1,2,3,2},
			{9,2,3,1,3,0},
			{1,2,3,1,0,0},
			{0,3,2,3,3,1},
			{0,2,3,1,0,0},
			{1,1,3,2,0,2},
			{0,1,1,2,3,2}};